# SETTINGS
cell_size,16
background_color,blue

# TILEMAP
0,0,0,0,0,0,0,0,0,0,0,0,0,0,0,0,0,0,0,0,0,0,0,0,0,0,0,0,0,0,0,0,0,0,2,0,0,0,0,0,0,0,0,0,0,0,0,0,0,0,0,0,0,0,0,0,0,0,0,0,0,0,0,0,0,0,0,0,0,0,0,0,0,0,0,0,0,0,0,0,0,0,0,0,0,0,0,0,0,0,0,0,0,0,0,0,0,0,0,0,0,0,0,0,0,0,0,0,0,0,0,0,0,0,0,0,0,0,0,0,0,0,0,0,0,0,0,0,0,0,0,0,0,0,0,0,0,0,0,0,0,0,0,0,0,0,0,0,0,0,0,0,0,0,0,0,0,0,0,0,0,0,0,0,0,0,0,0,0,0,0,0
0,0,0,0,0,0,0,0,0,0,0,0,0,0,0,0,0,0,0,0,0,0,0,0,0,0,0,0,0,0,0,0,0,0,0,0,0,0,0,0,0,0,0,0,0,2,0,0,0,0,0,0,0,0,2,0,0,0,0,0,0,0,0,0,0,0,0,0,0,0,0,0,0,0,0,0,0,0,0,0,0,0,0,0,0,2,0,0,0,0,0,0,0,0,0,0,0,0,0,0,0,0,0,0,0,0,0,0,0,0,0,0,0,0,0,0,0,0,0,0,0,0,0,0,0,0,0,0,0,0,0,0,0,0,0,0,0,0,0,0,0,0,0,0,0,0,0,0,0,0,0,0,0,0,0,0,0,0,0,0,0,0,0,0,0,0,0,0,0,0,0,0
0,0,0,0,0,0,0,0,2,0,0,0,0,0,0,0,0,0,0,0,0,0,0,0,0,0,0,0,0,0,0,0,0,0,0,0,0,0,0,0,0,0,0,0,0,0,0,0,0,0,0,0,0,0,0,0,0,0,0,0,0,0,0,0,0,2,0,0,0,0,0,2,0,0,0,0,0,0,2,0,0,0,0,0,0,0,0,0,2,0,0,0,0,0,0,0,0,0,0,2,0,0,0,0,0,0,0,0,0,0,0,2,0,0,0,0,2,0,0,0,0,0,0,2,0,0,0,0,0,0,0,0,0,0,0,0,0,0,0,0,0,0,0,0,0,0,0,0,0,0,0,0,0,0,0,0,0,0,0,0,0,0,0,0,0,0,0,0,0,0,0,0
0,0,0,0,0,0,0,0,0,0,0,0,0,0,0,0,0,0,0,0,0,2,0,0,0,0,0,0,0,0,0,0,0,0,0,0,0,0,0,0,2,0,0,0,0,0,0,27,28,28,28,28,28,29,0,0,0,0,0,0,0,0,0,0,0,0,0,0,0,0,0,0,0,0,0,0,0,0,0,0,0,0,0,0,0,0,0,0,0,0,0,0,0,0,0,0,0,0,0,0,0,0,0,0,0,0,0,0,0,0,0,0,0,0,0,0,0,0,0,0,0,0,0,0,0,0,0,0,0,0,0,0,0,0,0,0,0,0,0,0,0,2,0,0,0,0,0,0,0,0,0,0,0,0,0,0,0,0,2,0,0,0,0,0,2,0,0,0,0,0,0,0
0,0,0,0,0,0,0,0,0,0,0,0,0,0,0,0,0,2,0,0,0,0,0,0,0,0,0,0,0,0,0,2,0,27,28,28,28,29,0,0,0,0,0,0,0,0,0,0,40,40,40,40,40,0,0,0,0,0,0,0,0,2,0,0,0,0,0,0,0,0,0,0,0,0,0,0,0,0,0,0,0,0,0,0,0,0,0,0,0,0,0,0,0,0,0,0,0,0,0,0,0,0,0,0,0,0,2,0,0,0,0,0,0,0,0,0,0,0,0,0,0,0,0,0,0,0,0,2,0,0,0,0,2,0,0,0,0,0,0,0,0,0,0,0,0,0,0,0,0,0,0,0,0,2,0,0,0,0,8,0,0,0,0,0,0,0,0,0,0,0,0,0
0,0,0,0,0,0,0,0,0,0,0,0,0,0,0,0,0,0,0,0,0,0,0,0,0,0,0,0,2,0,0,0,0,0,40,40,40,0,0,0,0,0,0,0,0,0,0,0,40,40,40,40,40,0,0,0,0,0,0,0,0,0,0,0,0,0,27,28,28,29,0,0,0,0,2,0,0,0,0,0,0,27,28,28,28,28,28,29,0,0,0,0,0,0,0,0,0,0,0,0,0,0,0,0,0,0,0,0,0,0,0,0,0,0,0,0,0,0,0,2,0,0,0,0,0,0,0,0,0,0,0,0,0,0,0,2,0,0,0,0,0,0,0,0,0,0,0,0,5,5,0,0,0,0,0,0,0,0,8,0,0,0,0,0,0,0,0,0,0,0,0,0
0,0,0,0,0,0,0,0,0,0,0,0,0,2,0,0,0,0,0,0,0,0,0,0,0,0,0,0,0,0,0,0,0,0,40,40,40,0,0,0,0,0,2,0,0,0,0,0,40,40,40,40,40,0,0,0,0,0,0,0,0,0,0,0,0,0,0,40,40,0,0,0,0,0,0,0,0,0,0,0,0,0,40,40,40,40,40,0,0,0,27,28,28,28,28,28,28,28,28,28,28,29,0,0,0,0,0,0,0,0,0,0,0,0,0,0,0,0,0,0,0,0,0,0,0,0,0,0,0,0,0,0,0,0,0,0,0,0,0,0,0,0,0,0,0,0,0,0,5,5,0,0,0,0,0,0,0,0,8,0,0,0,0,0,0,0,0,0,0,0,0,0
0,0,0,0,0,0,0,0,0,0,0,0,0,0,0,0,0,0,0,0,0,0,0,0,0,0,0,0,0,0,0,0,0,0,40,40,40,0,0,0,0,0,27,28,28,28,29,0,40,40,40,40,40,0,0,0,2,0,0,0,0,0,0,0,0,0,0,40,40,0,0,0,0,0,0,0,0,0,0,0,0,0,40,40,40,40,40,0,0,0,0,40,40,40,40,40,40,40,40,40,40,0,0,0,0,0,0,0,0,0,27,28,28,28,28,28,28,29,0,0,0,0,0,0,0,0,0,0,0,0,0,0,0,0,0,0,0,0,0,0,0,0,0,0,0,0,5,5,5,5,0,0,0,0,0,0,0,0,8,0,0,0,0,0,0,0,0,0,0,0,0,0
0,0,0,0,0,0,0,0,0,0,0,0,0,0,0,0,0,0,0,0,0,0,0,0,0,0,0,0,0,0,0,27,28,28,28,28,28,28,29,0,0,0,0,40,40,40,0,0,40,40,40,40,40,0,0,0,27,28,28,28,28,28,28,28,29,0,0,40,40,0,0,0,0,0,0,0,0,0,0,0,0,0,40,40,40,40,40,0,0,0,0,40,40,40,40,40,40,40,40,40,40,0,0,0,0,0,0,0,0,0,0,40,40,40,40,40,40,0,0,0,0,0,0,0,0,0,0,0,0,0,0,0,0,0,0,0,0,0,0,0,0,0,0,0,0,0,5,5,5,5,0,0,0,0,0,0,0,0,8,0,0,0,0,0,0,0,0,0,0,0,0,0
0,0,0,0,0,0,0,0,0,0,0,0,0,0,0,0,0,0,0,0,0,0,0,0,0,0,0,0,0,0,0,0,40,40,40,40,40,40,0,0,0,0,0,40,40,40,0,0,40,40,40,40,40,0,0,0,0,40,40,40,40,40,40,40,0,2,0,40,40,0,0,0,2,0,0,0,27,28,29,0,0,0,40,40,40,40,40,0,0,0,0,40,40,40,40,40,40,40,40,40,40,0,0,0,0,0,0,0,0,0,0,40,40,40,40,40,40,0,0,0,0,0,27,28,28,29,0,0,27,28,28,29,0,0,0,0,0,0,0,0,0,0,0,0,5,5,5,5,5,5,0,0,0,0,0,0,0,0,8,0,0,0,0,0,0,0,0,0,0,0,0,0
0,0,0,0,0,0,0,0,0,0,0,0,0,0,0,0,0,0,0,0,0,0,0,0,0,27,28,28,29,0,0,0,40,40,40,40,40,40,0,0,0,0,0,40,40,40,0,0,40,40,40,40,40,0,2,0,0,40,40,40,40,40,40,40,0,0,0,40,40,0,0,0,0,0,0,0,0,40,0,0,0,0,40,40,40,40,40,0,0,0,0,40,40,40,40,40,40,40,40,40,40,0,0,0,0,0,0,0,0,0,0,40,40,40,40,40,40,0,0,0,0,0,0,40,40,0,0,0,0,40,40,0,0,0,0,0,0,0,0,0,0,0,0,0,5,5,5,5,5,5,0,0,0,0,0,0,0,0,8,0,0,0,0,0,0,0,0,0,0,0,0,0
0,0,0,0,0,0,0,0,0,0,0,0,0,0,0,0,0,0,0,0,0,0,0,0,0,0,40,40,0,0,0,0,40,40,40,40,40,40,0,27,28,29,0,40,40,40,0,0,40,40,40,40,40,0,0,0,0,40,40,40,40,40,40,40,0,0,0,40,40,0,0,0,0,0,0,0,0,40,0,0,0,0,40,40,40,40,40,0,0,2,0,40,40,40,40,40,40,40,40,40,40,0,2,0,27,28,28,29,0,0,0,40,40,40,40,40,40,0,0,0,0,0,0,40,40,0,0,0,0,40,40,0,0,0,0,0,0,0,0,0,0,0,0,0,5,5,5,5,5,5,0,0,0,0,0,0,0,0,8,0,0,0,0,0,0,0,0,0,0,0,0,0
9,0,0,0,0,0,0,0,0,0,0,0,0,0,0,0,0,0,0,0,0,0,0,0,0,0,40,40,0,0,2,0,40,40,40,40,40,40,0,0,40,0,0,40,40,40,0,0,40,40,40,40,40,0,0,0,0,40,40,40,40,40,40,40,0,0,0,40,40,0,0,0,0,0,0,0,0,40,0,0,0,0,40,40,40,40,40,0,0,0,0,40,40,40,40,40,40,40,40,40,40,0,0,0,0,40,40,0,0,2,0,40,40,40,40,40,40,0,0,0,0,0,0,40,40,0,0,0,0,40,40,0,0,0,0,0,0,0,0,0,0,0,0,0,5,5,5,5,5,5,0,0,0,0,0,0,0,0,5,0,0,0,0,9,0,0,0,0,0,0,0,0
1,1,1,1,1,1,1,1,1,1,1,1,1,1,1,1,1,1,1,1,1,1,1,1,1,0,40,40,0,0,0,0,40,40,40,40,40,40,0,0,40,0,0,40,40,40,0,0,40,40,40,40,40,0,0,0,0,40,40,40,40,40,40,40,0,27,28,28,28,29,0,27,28,28,28,29,0,40,0,0,0,0,40,40,40,40,40,0,0,0,0,40,40,40,40,40,40,40,40,40,40,0,0,0,0,40,40,0,0,0,0,40,40,40,40,40,40,0,0,27,28,29,0,40,40,0,0,0,0,40,40,0,0,0,0,1,1,1,1,1,1,1,1,1,1,1,1,1,1,1,1,1,1,1,1,1,1,1,1,1,1,1,1,1,1,1,1,1,1,1,1,1
1,1,1,1,1,1,1,1,1,1,1,1,1,1,1,1,1,1,1,1,1,1,1,1,1,0,40,40,0,0,0,0,40,40,40,40,40,40,0,0,40,0,0,40,40,40,0,0,40,40,40,40,40,0,0,0,0,40,40,40,40,40,40,40,0,0,40,40,40,0,0,0,40,40,40,0,0,40,0,0,0,0,40,40,40,40,40,0,0,0,0,40,40,40,40,40,40,40,40,40,40,0,0,0,0,40,40,0,0,0,0,40,40,40,40,40,40,0,0,0,40,0,0,40,40,0,0,0,0,40,40,0,0,0,0,1,1,1,1,1,1,1,1,1,1,1,1,1,1,1,1,1,1,1,1,1,1,1,1,1,1,1,1,1,1,1,1,1,1,1,1,1

# OBJECTS
type,x,y,extra
mario,48,192
decor,0,192,ani=ANI_2FLOORS_CASTLE_ASSEMBLED
goomba,352,144
goomba,400,160
koopa,640,160,type=red_flying
lucky_block,1092,32,item=mushroom
lucky_block,800,112,item=flower
lucky_block,816,112,item=coin
lucky_block,832,112,item=coin
decor,1900,192,ani=ANI_3FLOORS_CASTLE_ASSEMBLED
# Hill/Cloud decoration
hill_big,256,192
cloud_small,512,64
cloud_small,800,48

